{
  "id": 1,
  "width": 20,
  "height": 20,
  "layers": [
    {
      "id": "FLOOR",
      "usedSpriteSheets": [
        {
          "fileName": "Dungeon_Autotiles",
          "usedSpriteGroups": [
            {
              "groupID": "cobble_stone_sandy_wet",
              "usedSprites": [
                "wet_bottom_right",
                "wet_bottom",
                "wet_bottom_left",
                "dry_bottom_right",
                "dry_bottom_left",
                "wet_right",
                "wet_full",
                "wet_left",
                "dry_top_right",
                "dry_top_left",
                "wet_top_right",
                "wet_top",
                "wet_top_left"
              ]
            }
          ]
        },
        {
          "fileName": "Dungeon_WallsAndFloors",
          "usedSpriteGroups": [
            {
              "groupID": "floor_tiles",
              "usedSprites": [
                "cobble_stone_sandy",
                "tiles_stone_ornate_sandy",
                "tiles_stone_sandy",
                "empty_dark"
              ]
            }
          ]
        }
      ],
      "spriteLayout": [
        [999,999,999,999,999,999,999,999,999,999,999,999,999,999,999,999,999,999,999,999],
        [999,999,999,13,13,999,999,999,999,999,999,999,999,999,999,999,999,999,999,999],
        [999,999,999,13,13,999,999,999,999,999,999,999,999,999,999,999,999,999,999,999],
        [999,999,999,13,13,999,999,999,999,999,999,999,999,999,999,999,999,999,999,999],
        [999,13,13,13,13,13,13,13,13,13,13,13,13,13,13,13,13,13,13,999],
        [999,13,13,13,13,13,13,13,13,13,13,13,13,13,13,13,13,13,13,999],
        [999,13,13,14,15,14,15,13,13,13,13,13,13,13,13,13,13,13,13,999],
        [999,13,13,15,14,15,14,13,13,13,13,13,13,13,13,13,13,13,13,999],
        [999,13,13,14,15,14,15,13,13,13,13,13,13,13,13,13,13,13,13,999],
        [999,13,13,15,14,15,14,13,13,13,13,13,13,13,13,13,13,13,13,999],
        [999,13,13,13,13,13,13,13,13,13,13,13,13,13,13,13,13,13,13,999],
        [999,13,13,13,13,13,13,13,13,13,13,13,13,13,13,13,13,13,13,999],
        [999,13,13,13,13,13,13,13,13,13,13,13,13,13,13,13,13,13,13,999],
        [999,13,13,13,13,13,13,13,13,13,13,13,0,1,1,1,1,1,2,999],
        [999,13,13,13,13,13,13,13,13,13,13,13,5,6,6,6,6,6,7,999],
        [999,13,13,13,13,13,13,13,13,13,13,13,5,6,6,6,6,6,7,999],
        [999,13,13,13,13,13,13,13,13,13,13,13,5,6,6,6,6,6,7,999],
        [999,13,13,13,13,13,13,13,13,13,13,13,5,6,6,6,3,11,12,999],
        [999,13,13,13,13,13,13,13,13,13,13,13,10,11,11,11,12,13,13,999],
        [999,999,999,999,999,999,999,999,999,999,999,999,999,999,999,999,999,999,999,999]
      ]
    },
    {
      "id": "DEKORATIONS",
      "usedSpriteSheets": [
        {
          "fileName": "DungeonDecorations",
          "usedSpriteGroups": [
            {
              "groupID": "shelf",
              "usedSprites": [
                "horizontal_base_empty",
                "horizontal_base_bones",
                "horizontal_base_books",
                "horizontal_top",
                "vertical"
              ]
            },
            {
              "groupID": "wood_colum_beam_framing",
              "usedSprites": [
                "column_base"
              ]
            }
          ]
        }
      ],
      "spriteLayout": [
        [999,999,999,999,999,999,999,999,999,999,999,999,999,999,999,999,999,999,999,999,999],
        [999,999,999,999,999,999,999,999,999,999,999,999,999,999,999,999,999,999,999,999,999],
        [999,999,999,999,999,999,999,999,999,999,999,999,999,999,999,999,999,999,999,999,999],
        [999,999,999,999,999,999,999,999,999,999,999,999,999,999,999,999,999,999,999,999,999],
        [999,999,999,999,999,999,999,999,999,999,999,999,999,999,999,999,999,999,999,999,999],
        [999,999,999,999,999,999,999,999,999,999,999,999,999,999,999,999,999,999,999,999,999],
        [999,999,999,999,999,999,999,999,999,999,999,999,999,999,999,999,999,999,999,999,999],
        [999,999,999,999,999,999,999,999,999,999,999,999,999,999,999,999,999,999,999,999,999],
        [999,999,999,999,999,999,999,999,999,999,999,999,999,999,999,999,999,999,999,999,999],
        [999,999,999,999,999,999,999,999,999,999,999,999,999,999,999,999,999,999,999,999,999],
        [999,999,999,999,999,999,999,999,999,999,999,999,999,999,999,999,999,999,999,999,999],
        [999,999,999,999,999,999,999,999,999,999,999,999,999,999,999,999,999,999,999,999,999],
        [999,999,999,999,999,999,999,999,999,999,999,999,999,999,999,999,999,999,999,999,999],
        [999,999,999,999,999,999,999,999,999,999,999,999,999,999,999,999,999,999,999,999,999],
        [999,999,999,999,999,999,999,999,999,999,999,999,999,999,999,999,999,999,999,999,999],
        [999,999,999,999,999,999,999,999,999,999,999,999,999,999,999,999,999,999,999,999,999],
        [999,999,999,999,999,999,999,999,999,999,999,999,999,999,999,999,999,999,999,999,999],
        [999,999,999,999,999,999,999,999,999,999,999,999,999,999,999,999,999,999,999,999,999],
        [999,999,999,999,999,999,999,999,999,999,999,999,999,999,999,999,999,999,999,999,999],
        [999,999,999,999,999,999,999,999,999,999,999,999,999,999,999,999,999,999,999,999,999],
        [999,999,999,999,999,999,999,999,999,999,999,999,999,999,999,999,999,999,999,999,999]
      ]
    },
    {
      "id": "WALLS",
      "usedSpriteSheets": [
        {
          "fileName": "Dungeon_WallsAndFloors",
          "usedSpriteGroups": [
            {
              "groupID": "cobble_stone_sandy_wet",
              "usedSprites": [
                "top_broken",
                "top_cracked",
                "middle_broken",
                "middle_cracked",
                "bottom_broken",
                "bottom_cracked",
                "top",
                "middle",
                "bottom"
              ]
            },
            {
              "groupID": "stone_trim",
              "usedSprites": [
                "top_left_outer",
                "top",
                "top_right_outer",
                "left",
                "right",
                "bottom_left_outer",
                "bottom",
                "bottom_right_outer",
                "bottom_right_inner",
                "bottom_left_inner",
                "top_right_inner",
                "top_left_inner"
              ]
            }
          ]
        }
      ],
      "spriteLayout": [
        [999,999,999,999,999,999,999,999,999,999,999,999,999,999,999,999,999,999,999,999,999],
        [999,999,999,999,999,999,999,999,999,999,999,999,999,999,999,999,999,999,999,999,999],
        [999,999,999,999,999,999,999,999,999,999,999,999,999,999,999,999,999,999,999,999,999],
        [999,999,999,999,999,999,999,999,999,999,999,999,999,999,999,999,999,999,999,999,999],
        [999,999,999,999,999,999,999,999,999,999,999,999,999,999,999,999,999,999,999,999,999],
        [999,999,999,999,999,999,999,999,999,999,999,999,999,999,999,999,999,999,999,999,999],
        [999,999,999,999,999,999,999,999,999,999,999,999,999,999,999,999,999,999,999,999,999],
        [999,999,999,999,999,999,999,999,999,999,999,999,999,999,999,999,999,999,999,999,999],
        [999,999,999,999,999,999,999,999,999,999,999,999,999,999,999,999,999,999,999,999,999],
        [999,999,999,999,999,999,999,999,999,999,999,999,999,999,999,999,999,999,999,999,999],
        [999,999,999,999,999,999,999,999,999,999,999,999,999,999,999,999,999,999,999,999,999],
        [999,999,999,999,999,999,999,999,999,999,999,999,999,999,999,999,999,999,999,999,999],
        [999,999,999,999,999,999,999,999,999,999,999,999,999,999,999,999,999,999,999,999,999],
        [999,999,999,999,999,999,999,999,999,999,999,999,999,999,999,999,999,999,999,999,999],
        [999,999,999,999,999,999,999,999,999,999,999,999,999,999,999,999,999,999,999,999,999],
        [999,999,999,999,999,999,999,999,999,999,999,999,999,999,999,999,999,999,999,999,999],
        [999,999,999,999,999,999,999,999,999,999,999,999,999,999,999,999,999,999,999,999,999],
        [999,999,999,999,999,999,999,999,999,999,999,999,999,999,999,999,999,999,999,999,999],
        [999,999,999,999,999,999,999,999,999,999,999,999,999,999,999,999,999,999,999,999,999],
        [999,999,999,999,999,999,999,999,999,999,999,999,999,999,999,999,999,999,999,999,999],
        [999,999,999,999,999,999,999,999,999,999,999,999,999,999,999,999,999,999,999,999,999]
      ]
    },
    {
      "id": "CEILING",
      "usedSpriteSheets": [
        {
          "fileName": "DungeonDecorations",
          "usedSpriteGroups": [
            {
              "groupID": "wood_colum_beam_framing",
              "usedSprites": [
                "column_head_end",
                "column_head_beam",
                "beam_horizontal",
                "beam_horizontal_damaged",
                "beam_horizontal_end_right",
                "beam_horizontal_end_left",
                "beam_vertical",
                "beam_vertical_damaged",
                "beam_vertical_end"
              ]
            }
          ]
        }
      ],
      "spriteLayout": [
        [999,999,999,999,999,999,999,999,999,999,999,999,999,999,999,999,999,999,999,999,999],
        [999,999,999,999,999,999,999,999,999,999,999,999,999,999,999,999,999,999,999,999,999],
        [999,999,999,999,999,999,999,999,999,999,999,999,999,999,999,999,999,999,999,999,999],
        [999,999,999,999,999,999,999,999,999,999,999,999,999,999,999,999,999,999,999,999,999],
        [999,999,999,999,999,999,999,999,999,999,999,999,999,999,999,999,999,999,999,999,999],
        [999,999,999,999,999,999,999,999,999,999,999,999,999,999,999,999,999,999,999,999,999],
        [999,999,999,999,999,999,999,999,999,999,999,999,999,999,999,999,999,999,999,999,999],
        [999,999,999,999,999,999,999,999,999,999,999,999,999,999,999,999,999,999,999,999,999],
        [999,999,999,999,999,999,999,999,999,999,999,999,999,999,999,999,999,999,999,999,999],
        [999,999,999,999,999,999,999,999,999,999,999,999,999,999,999,999,999,999,999,999,999],
        [999,999,999,999,999,999,999,999,999,999,999,999,999,999,999,999,999,999,999,999,999],
        [999,999,999,999,999,999,999,999,999,999,999,999,999,999,999,999,999,999,999,999,999],
        [999,999,999,999,999,999,999,999,999,999,999,999,999,999,999,999,999,999,999,999,999],
        [999,999,999,999,999,999,999,999,999,999,999,999,999,999,999,999,999,999,999,999,999],
        [999,999,999,999,999,999,999,999,999,999,999,999,999,999,999,999,999,999,999,999,999],
        [999,999,999,999,999,999,999,999,999,999,999,999,999,999,999,999,999,999,999,999,999],
        [999,999,999,999,999,999,999,999,999,999,999,999,999,999,999,999,999,999,999,999,999],
        [999,999,999,999,999,999,999,999,999,999,999,999,999,999,999,999,999,999,999,999,999],
        [999,999,999,999,999,999,999,999,999,999,999,999,999,999,999,999,999,999,999,999,999],
        [999,999,999,999,999,999,999,999,999,999,999,999,999,999,999,999,999,999,999,999,999],
        [999,999,999,999,999,999,999,999,999,999,999,999,999,999,999,999,999,999,999,999,999]
      ]
    }
  ]
}